sequence_id,length,A,T,C,G,GC,ORFs
XR_004528955.1,5510,1398,1287,1322,1503,2825,54
XR_003432807.1,5297,1352,1254,1287,1404,2691,54
EU839660.2,7027,1766,1766,1680,1791,3471,66
NG_033026.1,14753,3707,3658,3710,3678,7388,168
XM_006751376.2,1277,202,174,468,433,901,6
XM_029206207.1,2338,488,486,745,619,1364,30
XM_022571463.1,2338,488,488,742,620,1362,30
XM_032646053.1,2351,492,496,744,619,1363,30
XM_024736991.1,2350,489,495,743,623,1366,30
XM_024122730.2,1245,243,185,407,410,817,9
XM_007125804.3,2511,530,521,766,694,1460,36
XM_036864619.1,2369,489,502,752,626,1378,30
XM_030866799.1,2416,500,500,757,659,1416,33
XM_004274236.4,2700,561,542,837,760,1597,33
XM_040641960.1,894,142,134,320,298,618,6
